XXXXXXXXXXXXXXXXXXXXX
X.....X.......X.X...X
XXX.X.X.X.X.XXX.X.XXX
X...X.X.X.X...X.....X
X.XXXXXXXXX.X.XXXXX.X
X.......X...X...X...X
X.XXX.XXX.X.XXX.X.XXX
X...X.....X...X.....X
X.XXXXXXXXX.XXXXXXXXX
X.X.......X.X.X.....X
X.XXXXXXX.XXX.XXXXX.X
X.........X.X.......X
X.XXXXXXX.X.XXXXXXX.X
X.X.X.X.X.....X.X...X
X.X.X.X.X.XXXXX.XXX.X
X...X.....X.....X...X
XXXXXXX.X.XXX.XXX.X.X
X.......X.X.......X.X
X.XXXXXXX.X.XXXXXXX.X
X.......X.......X...X
XXXXXXXXXXXXXXXXXXXXX