XXXXXXXXXXXXXXX
X............XX
X...X......XX.X
XX.XX.....X...X
X...XX...X....X
X...X....X....X
X...X....X....X
X.XXX...XX....X
X...X....X....X
X...X....X....X
X........X....X
XXXXX...X.....X
X...X.X...X...X
X......XX.....X
XXXXXXXXXXXXXXX