XXXXXXXXXXXXXXX
XXXXXXX.......X
X........X...XX
XX.......X...XX
XX.......X...XX
XX.......X...XX
XX.......X....X
XX.......X....X
XXXXXX.XXX....X
XX........X...X
XXXXXXXX...X..X
XX..........X.X
X............XX
X.............X
XXXXXXXXXXXXXXX