XXXXXXXXXXXXXXXXXXXXX
X...................X
X...................X
X...................X
X...................X
X..............X....X
XXXXXXXXXXXXXXXX....X
XX.............X....X
XX.............X....X
XX.........XXXXX....X
XX.............X....X
XX.............X....X
XX.............X....X
XX.............X....X
X..............X....X
X..............X....X
X..............X....X
X..............X....X
X...................X
X...................X
XXXXXXXXXXXXXXXXXXXXX


